0333333333333333333333333333333330
2000000000000000000000000000000002
2000111111110000000000000000000002
2000111111110000000000000000000002
2000111111110000000000000000000002
2000111111110000000000000000000002
2000111111110000000000000000000002
2000000000000000000000000000000002
2000000000000000000000000000000002
2000000000000000000000011111111002
2000000000000000000000011111111002
2000000000000000000000011111111002
2000000000000000000000011111111002
2000000000000004000000011111111002
2000000000000000000000000000000002
2000000000000000000000000000000002
2000111111110000000000000000000002
2000111111110000000000000000000002
2000111111110000000000000000000002
2000111111110000000000000000000002
2000111111110000000000000000000002
2000000000000000000000000000000002
2000000000000000000000000000000002
2000000000000000000000000000000002
0333333333333333333333333333333330